1 1 1 1 1 1 1 1 1 1 1 1 1 1 1 1 1 1 1 1
1 1 1 1 1 1 1 1 1 1 1 1 1 1 1 1 1 1 1 1
1 1 1 1 1 1 1 1 1 1 1 1 1 1 1 1 1 1 1 1
1 1 1 1 1 1 1 1 1 1 1 2 2 2 2 2 2 2 2 1
1 1 1 1 1 1 1 1 1 1 1 2 3 3 5 5 5 5 2 1
2 2 2 2 2 2 2 2 2 2 2 2 3 3 5 5 5 5 2 1
2 3 3 3 3 2 3 3 4 3 4 3 3 3 5 5 5 5 2 1
2 3 4 4 4 2 4 3 3 4 3 2 3 3 5 5 5 5 2 1
2 3 3 4 3 3 3 3 3 4 3 2 3 3 5 5 5 5 2 1
2 3 4 4 3 2 4 3 4 3 4 2 2 2 2 2 2 2 2 1
2 3 3 4 3 2 3 3 3 3 3 2 1 1 1 1 1 1 1 1
2 2 3 2 2 2 2 2 2 2 2 2 1 1 1 1 1 1 1 1
2 3 3 3 3 2 3 3 3 3 2 2 1 1 1 1 1 1 1 1
2 3 3 3 3 3 4 3 3 3 2 2 1 1 1 1 1 1 1 1
2 3 3 4 4 2 4 4 3 3 6 2 1 1 1 1 1 1 1 1
2 3 3 3 3 2 3 3 3 3 2 2 1 1 1 1 1 1 1 1
2 2 2 2 2 2 2 2 2 2 2 1 1 1 1 1 1 1 1 1
1 1 1 1 1 1 1 1 1 1 1 1 1 1 1 1 1 1 1 1
1 1 1 1 1 1 1 1 1 1 1 1 1 1 1 1 1 1 1 1
1 1 1 1 1 1 1 1 1 1 1 1 1 1 1 1 1 1 1 1